*****************************
********1*2*3*4*   *       5*
*                  *     ****
*B                 *       6*
*9                       ****
*8                         7*
********           **********
*      *                    *
*      *                    *
*     A            a        *
*****************************